Moveables_PL = {
50s_Barstool = 	 "Sto³ek z lat 50.",
50s_Seat = 	 "Siedzisko z lat 50.",
99_Cent_Sale_Sign = 	 "Znak wyprzeda¿y 99 centów",
Acacia_Tiles = 	 "P³ytki Akacja",
Administrative_Flag = 	 "Flaga administracyjna",
Adult_Education_Sign = 	 "Znak szko³y dla doros³ych",
Advertisement_Notices = 	 "Tablica informacyjna",
Air_Blower = 	 "Suszarka do r¹k",
Air_Conditioner = 	 "Klimatyzacja",
Angelic_Gravestone = 	 "Nagrobek – anio³",
Antique_Outdoor_Lamp = 	 "Stara lampa zewnêtrzna",
Antique_Oven = 	 "Stary piec",
Antique_Television = 	 "Stary telewizor",
Arched_Gravestone = 	 "Nagrobek – ³uk",
Awl_Sew_Sign = 	 "Znak Awl Sew",
Bail_Bonds_Sign = 	 "Znak Bail Bonds",
Bakery_Sign = 	 "Znak piekarni",
Bar_Corner_Counter = 	 "Bar naro¿ny",
Bar_Counter = 	 "Bar",
Bar_Floor = 	 "Pod³oga baru",
Bar_Stool = 	 "Sto³ek barowy",
Bar_Wall_Shelves = 	 "Barowe pó³ki œcienne",
Barbecue = 	 "Grill",
Barg_n_Clothes_Sign = 	 "Znak Barg n Clothes",
BargnClothes_Sign = 	 "Znak BargnClothes",
Barrel = 	 "Beczka",
Barrier_Post = 	 "S³upek",
Bathroom_Rug = 	 "Dywanik ³azienkowy",
Battered_Cartboard_Box = 	 "Pognieciony karton",
Battered_Gravestone = 	 "Ukruszony nagrobek",
Battered_Notices = 	 "Uszkodzona tablica og³oszeniowa",
Beach_Chair = 	 "Le¿ak pla¿owy",
Bedroom_Drawers = 	 "Szafka nocna",
Beige_Carpet = 	 "Be¿owy dywan",
Beige_Checkered_Tiles = 	 "Be¿owe p³ytki w kratkê",
Beige_Curtain = 	 "Be¿owa zas³ona",
Beige_Magazine_Shop_Shelves = 	 "Be¿owe pó³ki sklepowe",
Beige_Rack_Shop_Shelves = 	 "Be¿owe pó³ki magazynowe",
Beige_Sink = 	 "Be¿owa umywalka",
Beige_Smooth_Tiles = 	 "Be¿owe g³adkie p³ytki",
Beige_Tiles = 	 "Be¿owe p³ytki",
Beige_Wall_Shop_Shelves = 	 "Be¿owe sklepowe pó³ki naœcienne",
Betty_Painting = 	 "Obraz Betty",
Big_Cork_Noteboard = 	 "Du¿a korkowa tablica",
Big_Wall_Shelves = 	 "Du¿e pó³ki naœcienne",
Birchwood_Corner_Counter = 	 "Brzozowa lada naro¿na",
Birchwood_Counter = 	 "Brzozowa lada",
Birchwood_Floating_Counter = 	 "Brzozowa lada podwieszana",
Birchwood_Floor = 	 "Brzozowe panele",
Birchwood_Tiles = 	 "Brzozowe p³ytki",
Black_Carpet = 	 "Czarny dywan",
Black_Cash_Register = 	 "Czarna kasa fiskalna",
Black_Curtain = 	 "Czarna zas³ona",
Black_Diagonal_Tiles = 	 "Czarne ukoœne p³ytki",
Black_Fancy_Chair = 	 "Czarny ekskluzywny fotel",
Black_Lamp = 	 "Czarna lampa",
Black_Low_Modern_Table = 	 "Czarny niski nowoczesny stó³",
Black_Office_Chair = 	 "Czarny biurowy fotel",
Black_Tiles = 	 "Czarne p³ytki",
Blowout_Sign = 	 "Znak Blowout",
Blue_Bar_Stool = 	 "Niebieski sto³ek barowy",
Blue_Bed = 	 "Niebieskie ³ó¿ko",
Blue_Carpet = 	 "Niebieski dywan",
Blue_Checkered_Tiles = 	 "Niebieskie p³ytki w kratkê",
Blue_Comfy_Chair = 	 "Niebieski wygodny fotel",
Blue_Comfy_Couch = 	 "Niebieska wygodna kanapa",
Blue_Cross_Sign = 	 "Znak Blue Cross",
Blue_Curtain = 	 "Niebieskie zas³ony",
Blue_Dumpster = 	 "Niebieski kontener na œmieci",
Blue_Fossoil_Floor = 	 "Niebieska pod³oga Fossoil",
Blue_Fridge = 	 "Niebieska lodówka",
Blue_Hospital_Curtain_A = 	 "Niebieskie zas³ony szpitalne A",
Blue_Hospital_Curtain_B = 	 "Niebieskie zas³ony szpitalne B",
Blue_Hospital_Curtain_C = 	 "Niebieskie zas³ony szpitalne C",
Blue_Hospital_Curtain_D = 	 "Niebieskie zas³ony szpitalne D",
Blue_Lamp = 	 "Niebieska lampa",
Blue_Picknic_Table = 	 "Niebieski stó³ piknikowy",
Blue_Pie_Poster = 	 "Niebieski plakat z ciastem",
Blue_Plastic_Chair = 	 "Niebieskie plastikowe krzes³o",
Blue_Rattan_Chair = 	 "Niebieski rattanowy fotel",
Blue_Rattan_Couch = 	 "Niebieska rattanowa kanapa",
Blue_Seat = 	 "Niebieskie siedzisko",
Blue_Theatre_Chair = 	 "Niebieski fotel kinowy",
Blue_Wall_Locker = 	 "Niebieskie szafki naœcienne",
Blue_Washing_Machine = 	 "Niebieska pralka",
Blue_Zippee_Floor = 	 "Niebieska pod³oga Zippee",
Bonsai_Tree = 	 "Drzewko Bonsai",
Book_Naked_Sign = 	 "Znak Book Naked",
Bordeaux_Carpet = 	 "Bordowy dywan",
Bordeaux_Rug = 	 "Bordowy dywanik",
Bouquet_of_Roses = 	 "Bukiet ró¿",
Brick_Mall_Bench = 	 "Ceglana ³awka z CH",
Broad_White_Table = 	 "Szeroki bia³y stó³",
Brown_Carpet = 	 "Br¹zowy dywan",
Brown_Curtain = 	 "Br¹zowe zas³ony",
Brown_Lazy_Chair = 	 "Br¹zowy fotel wypoczynkowy",
Brown_Lazy_Couch = 	 "Br¹zowa kanapa wypoczynkowa",
Brown_Low_Table = 	 "Br¹zowy niski stó³",
Brown_Motel_Floor = 	 "Br¹zowa pod³oga motelowa",
Brown_Picknic_Table = 	 "Br¹zowy stó³ piknikowy",
Brown_Plant = 	 "Br¹zowa roœlina",
Brown_Tiles = 	 "Br¹zowe p³ytki",
Build_in_Trailer_Fridge = 	 "Wbudowana lodówka przyczepowa",
Bush = 	 "Krzak",
Cactus = 	 "Kaktus",
Callys_Gifts_Sign = 	 "Znak Callys Gifts",
Carlton_n_Sydney_Sign = 	 "Znak Carlton n Sydney",
Cartboard_Box = 	 "Karton",
Cartbox = 	 "Pude³ko",
Cash_Register = 	 "Kasa fiskalna",
Center_Sign = 	 "Znak Center",
Chalk_Board = 	 "Tablica",
Chemical_Toilet = 	 "Sedes turystyczny",
Chestnut_North_Floor = 	 "Pod³oga orzech pó³noc",
Chestnut_West_Floor = 	 "Pod³oga orzech zachód",
Childs_Drawing = 	 "Rysunek dziecka",
Childrens_Drawing = 	 "Rysunek dzieci",
China_Cabinet = 	 "Kredens",
Chrome_Microwave = 	 "Chromowana mikrofalówka",
Chrome_Sink = 	 "Chromowana umywalka",
Chrome_Window = 	 "Chromowane okno",
Church_Pew = 	 "£awka koœcielna",
Cinnamon_North_Floor = 	 "Pod³oga cynamon pó³noc",
Cinnamon_Tiles = 	 "P³ytki cynamon",
Cinnamon_West_Floor = 	 "Pod³oga cynamon zachód",
Citrus_Sign = 	 "Znak Citrus",
Clothes_Stand = 	 "Stojak na ubrania",
Clothing_Shop_Shelves = 	 "Pó³ki sklepowe na ubrania",
Coat_Rack = 	 "Wieszak na p³aszcze",
Coffee_High_Sign = 	 "Znak Coffee High",
Coffee_Low_Sign = 	 "Znak Coffee Low",
Collection_of_Notices = 	 "Zbiór og³oszeñ",
Comics_Shop_Shelves = 	 "Pó³ki sklepowe na komiksy",
Concrete_Road_Block = 	 "Betonowa zapora drogowa",
Cork_Noteboard = 	 "Tablica korkowa",
Crafted_Bed = 	 "Wytworzone ³ó¿ko",
Crafted_Counter = 	 "Wytworzona lada",
Crafted_Wall_Shelves = 	 "Wytworzone pó³ki œcienne",
Crafted_Wooden_Shelves = 	 "Wytworzone drewniane pó³ki",
Crafter_Corner_Counter = 	 "Wytworzona naro¿na lada",
Crate = 	 "Skrzynia",
Curtain = 	 "Zas³ona",
Dark_Corner_Counter = 	 "Ciemna naro¿na lada",
Dark_Counter = 	 "Ciemna lada",
Dark_Fancy_Drawers = 	 "Ciemne ekskluzywne szafki",
Dark_Fancy_Wardrobe = 	 "Ciemna ekskluzywna szafa",
Dark_Green_Rug = 	 "Ciemnozielony dywanik",
Dark_Grey_Carpet = 	 "Ciemnoszary dywan",
Dark_Grey_Rug = 	 "Ciemnoszary dywanik",
Dark_Grey_Tiles = 	 "Ciemnoszare p³ytki",
Dark_Industrial_Sink = 	 "Ciemna umywalka przemys³owa",
Dark_Purple_Rug = 	 "Ciemny fioletowy dywanik",
Dark_Red_Carpet = 	 "Ciemnoczerwony dywan",
Dark_Round_Table = 	 "Ciemny okr¹g³y stó³",
Dark_School_Bench = 	 "Ciemna ³awka szkolna",
Dark_Wall_Lamp = 	 "Ciemna lampa œcienna",
Dark_Wall_Shelves = 	 "Ciemne pó³ki œcienne",
Dark_Wooden_Chair = 	 "Ciemne drewniane krzes³o",
Darkblue_Modern_Chair = 	 "Ciemnoniebieskie nowoczesne krzes³o",
Decorated_Altar = 	 "Ozdobiony o³tarz",
Deluxe_Shower = 	 "Luksusowy prysznic",
Dentist_Patient_Chair = 	 "Fotel dentystyczny",
Desktop_Computer = 	 "Komputer stacjonarny",
Diner_Corner_Counter = 	 "Naro¿na lada Diner",
Diner_Counter = 	 "Lada Diner",
Diner_Floor = 	 "Pod³oga Diner",
Diner_Neon_Sign = 	 "Znak Diner Neon",
Dixie_Sign = 	 "Znak Dixie",
Doctor_Degree_Certificate = 	 "Dyplom lekarski",
Dog_House = 	 "Buda dla psa",
Door_Mat_Rug = 	 "Wycieraczka wejœciowa",
Double_Stacked_Hay = 	 "Kostki s³omy",
Dr_R_B_Mat_Dentistry_Sign = 	 "Znak Dr R B Mat dentysta",
Dr_Oids_Arcade_Machine = 	 "Automat do gier dr. Oidsa",
Dr_Oids_Painting = 	 "Obraz dr. Oidsa",
Dr_Oids_Poster = 	 "Plakat dr. Oidsa",
Drag_Racing_Sign = 	 "Znak Drag Racing",
Emergency_Sign = 	 "Znak Emergency",
Empty_Mall_Decoration = 	 "Pusta dekoracja z CH",
Empty_Pallet = 	 "Pusta paleta",
Enigma_Books_Sign = 	 "Znak Enigma Books",
Exceptional_Large_Table = 	 "Wyj¹tkowy du¿y stó³",
Exceptional_Table = 	 "Wyj¹tkowy stó³",
Exceptionally_crafted_Chair = 	 "Piêknie wykonane krzes³o",
Exit_Sign = 	 "Znak Exit",
Eye_Test_Poster = 	 "Plakat do badania wzroku",
Family_Fashion_Sign = 	 "Znak Family Fashion",
Fancy_Bed = 	 "Ekskluzywne ³ó¿ko",
Fancy_Blue_Rug = 	 "Ekskluzywny niebieski dywanik",
Fancy_Brown_Rug = 	 "Ekskluzywny br¹zowy dywanik",
Fancy_Counter = 	 "Ekskluzywna lada",
Fancy_Dark_Table = 	 "Ekskluzywny ciemny stó³",
Fancy_Drawers = 	 "Ekskluzywne szafki",
Fancy_Floating_Counter = 	 "Ekskluzywna podwieszana lada",
Fancy_Green_Rug = 	 "Ekskluzywny zielony dywanik",
Fancy_Hanging_Sink = 	 "Ekskluzywna podwieszana umywalka",
Fancy_Low_Glass_Table = 	 "Ekskluzywny niski szklany stó³",
Fancy_Low_Table = 	 "Ekskluzywny niski stó³",
Fancy_Oak_Drawers = 	 "Ekskluzywne dêbowe szafki",
Fancy_Oak_Wardrobe = 	 "Ekskluzywna dêbowa szafa",
Fancy_Orange_Rug = 	 "Ekskluzywny pomarañczowy dywanik",
Fancy_Outdoor_Lamp = 	 "Ekskluzywna zewnêtrzna lampa",
Fancy_Outdoors_Bench = 	 "Ekskluzywna zewnêtrzna ³awka",
Fancy_Table = 	 "Ekskluzywny stó³",
Fancy_Toilet = 	 "Ekskluzywny sedes",
Fancy_White_Chair = 	 "Ekskluzywne bia³e krzes³o",
Fancy_White_Wardrobe = 	 "Ekskluzywna bia³a szafa",
Fancy_Wooden_Chair = 	 "Ekskluzywne drewniane krzes³o",
Fancy_Wooden_Shop_Shelves = 	 "Ekskluzywne drewniane sklepowe pó³ki",
Fashion_Belle_Sign = 	 "Znak Fashion Belle",
Fern = 	 "Paproæ",
Finewood_Floor = 	 "Panele z drogiego drewna",
Fitness_Contraption = 	 "Przyrz¹d do fitnessu",
Floating_Trailer_Counter = 	 "Podwieszana przyczepowa lada",
Flowerbed = 	 "Donica",
Folding_Chair = 	 "Sk³adane krzes³o",
Foot_Bench = 	 "Podest",
For_Lease_Sign = 	 "Znak For Lease",
For_Sale_Sign = 	 "Znak For Sale",
Fossoil_Candy_Stand = 	 "Stojak na s³odycze Fossoil",
Fossoil_Corner_Counter = 	 "Naro¿na lada Fossoil",
Fossoil_Counter = 	 "Lada Fossoil",
Fossoil_Garbage_Bin = 	 "Œmietnik Fossoil",
Fossoil_Sign = 	 "Znak Fossoil",
Full_Grown_Corn = 	 "Dojrza³a kukurydza",
Garbage_Bin = 	 "Œmietnik",
Gas2Go_Corner_Counter = 	 "Naro¿na lada Gas2Go",
Gas2Go_Counter = 	 "Lada Gas2Go",
Generic_Racked_Shelves = 	 "Zwyk³e pó³ki",
Generic_Shop_Corner_Counter = 	 "Zwyk³a sklepowa lada naro¿na",
Generic_Shop_Counter = 	 "Zwyk³a sklepowa lada",
Glass_Corner_Display_Counter = 	 "Szklana naro¿na lada wystawowa",
Glass_Display_Counter = 	 "Szklana lada wystawowa",
Glass_Display_Display = 	 "Szklana wystawa",
Glass_Display_Stand = 	 "Szklany stojak wystawowy",
Glass_Theater_Counter = 	 "Szklana lada kinowa",
Green_Carpet = 	 "Zielony dywan",
Green_Comfy_Chair = 	 "Zielony wygodny fotel",
Green_Comfy_Couch = 	 "Zielona wygodna kanapa",
Green_Corner_Counter = 	 "Zielona lada naro¿na",
Green_Counter = 	 "Zielona lada",
Green_Curtain = 	 "Zielona zas³ona",
Green_Diagonal_Tiles = 	 "Zielone ukoœne p³ytki",
Green_Diner_Floor = 	 "Zielona pod³oga Diner",
Green_Dinner_Chair = 	 "Zielone krzes³o Dinner",
Green_Fridge = 	 "Zielona lodówka",
Green_Garbage_Bin = 	 "Zielony œmietnik",
Green_Oven = 	 "Zielony piekarnik",
Green_Pie_Poster = 	 "Zielony plakat z ciastem",
Green_Plant = 	 "Zielona roœlina",
Green_Tiles = 	 "Zielone p³ytki",
Green_Wall_Locker = 	 "Zielone szafki",
Greenes_Grocery_Display_Counter = 	 "Lada wystawowa Greene's Grocery",
Greenes_Grocery_Carpet = 	 "Dywan Greene's Grocery",
Greenes_Grocery_Carpet_B = 	 "Dywan B Greene's Grocery",
Greenes_Grocery_Floor = 	 "Pod³oga Greene's Grocery",
Greenes_Grocery_Shelves = 	 "Pó³ki Greene's Grocery",
Grey_Carpet = 	 "Szary dywan",
Grey_Chair = 	 "Szare krzes³o",
Grey_Checkered_Tiles = 	 "Szare p³ytki w kratkê",
Grey_Curly_Carpet = 	 "Szary w³ochaty dywan",
Grey_Curtain = 	 "Szara zas³ona",
Grey_Diagonal_Tiles = 	 "Szare ukoœne p³ytki",
Grey_File_Cabinet = 	 "Szara szafka na dokumenty",
Grey_Garbage_Bin = 	 "Szary œmietnik",
Grey_Lamp = 	 "Szara lampa",
Grey_Long_Curtain = 	 "Szara d³uga zas³ona",
Grey_Mall_Tile = 	 "Szare p³ytka z CH",
Grey_Oven = 	 "Szary piekarnik",
Grey_Smooth_Tiles = 	 "Szare g³adkie p³ytki",
Grey_Tiles = 	 "Szare p³ytki",
Grocery_Trapezoid_Counter = 	 "Trapezoidalna lada",
Groovy_Chic_Sign = 	 "Znak Groovy Chic",
Hair_Genesis_Sign = 	 "Znak Hair Genesis",
Hair_Studio_Sign = 	 "Znak Hair Studio",
Hanging_Seat = 	 "Podwieszane siedzisko",
Hanging_Toilet = 	 "Podwieszany sedes",
Hardwood_Floor = 	 "Panele z twardego drewna",
Hardwood_Tiles = 	 "Panele z twardego drewna",
Hardwood_Wall_Shelves = 	 "Pó³ki œcienne z twardego drewna",
Hay_Floor = 	 "Pod³oga ze s³omy",
Hospital_Bed = 	 "£ó¿ko szpitalne",
Hugo_Plush_Sign = 	 "Znak Hugo Plush",
Human_Hamster_Wheel = 	 "Ko³o dla ludzi",
Hunting_Sign = 	 "Znak Hunting",
Incognito_Library_Painting = 	 "Obraz Incognito Library",
Industrial_Fridge = 	 "Lodówka przemys³owa",
Industrial_Oven = 	 "Piekarnik przemys³owy",
Industrial_Sink = 	 "Zlew przemys³owy",
Inmates_Road_Sign = 	 "Znak Inmates Road",
Insurance_Sign = 	 "Znak Insurance",
Island_Beach_Painting = 	 "Obraz Island Beach",
Jolly_Good_Sign = 	 "Znak Jolly Good",
Jorge_Foreguy_Barbecue = 	 "Grill Jorge Foreguy",
Kaboom_Arcade_Machine = 	 "Automat do gier Kaboom",
Lage_Metal_Shelves = 	 "Du¿e metalowe pó³ki",
Lakeside_Painting = 	 "Obraz Lakeside",
Large_Bleached_Table = 	 "Du¿y wybielony stó³",
Large_Brown_Table = 	 "Du¿y br¹zowy stó³",
Large_Clothes_Rack = 	 "Du¿y wieszak na ubrania",
Large_Dark_Oak_Table = 	 "Du¿y stó³ z ciemnego dêbu",
Large_Dark_Table = 	 "Du¿y ciemny stó³",
Large_Dark_Wooden_Table = 	 "Du¿y stó³ z ciemnego drewna",
Large_Deluxe_Bath = 	 "Du¿a luksusowa wanna",
Large_Fancy_Bed = 	 "Du¿e ekskluzywne ³ó¿ko",
Large_Fridge = 	 "Du¿a lodówka",
Large_Light_Oak_Table = 	 "Du¿y stó³ z jasnego dêbu",
Large_Low_Shelves = 	 "Du¿e niskie pó³ki",
Large_Machine = 	 "Du¿a maszyna",
Large_Medical_Bed = 	 "Du¿e ³ó¿ko szpitalne",
Large_Mirror = 	 "Du¿e lustro",
Large_Modern_Bed = 	 "Du¿e nowoczesne ³ó¿ko",
Large_Modern_Oven = 	 "Du¿y nowoczesny piekarnik",
Large_Oak_Bed = 	 "Du¿e dêbowe ³ó¿ko",
Large_Oak_Table = 	 "Du¿y dêbowy stó³",
Large_Plant = 	 "Du¿a roœlina",
Large_Plastic_Table = 	 "Du¿y plastikowy stó³",
Large_Shop_Shelves = 	 "Du¿e sklepowe pó³ki",
Large_Simple_Table = 	 "Du¿y zwyk³y stó³",
Large_Smooth_Table = 	 "Du¿y g³adki stó³",
Large_Wardrobe = 	 "Du¿a szafa",
Large_White_Table = 	 "Du¿y bia³y stó³",
Laundromat_Sign = 	 "Znak Laundromat",
Leather_Bar_Seating = 	 "Skórzane siedzisko barowe",
Lectern_Stand = 	 "Mównica",
Left_Bar_Wall_Shelves = 	 "Lewe barowe pó³ki œcienne",
Legal_Services_Sign = 	 "Znak Legal Services",
Light_Blue_Chair = 	 "Jasnoniebieskie krzes³o",
Light_Blue_Couch = 	 "Jasnoniebieska kanapa",
Light_Low_Table = 	 "Jasny niski stó³",
Light_Round_Table = 	 "Jasny okr¹g³y stó³",
Light_School_Bench = 	 "Jasna ³awka szkolna",
Light_Wood_Drawers = 	 "Szafki z jasnego drewna",
Light_Wood_Restaurant_Table = 	 "Stó³ z restauracji z jasnego drewna",
Light_Wood_Wardrobe = 	 "Szafa z jasnego drewna",
Lightwood_Desk = 	 "Jasne biurko",
Lightwood_Trailer_Table = 	 "Jasny przyczepowy stó³",
Lightwood_Wall_Shelves = 	 "Jasne pó³ki œcienne",
Limon_Sign = 	 "Znak Limon",
Long_Beige_Curtain = 	 "D³uga be¿owa zas³ona",
Long_Dark_Table = 	 "D³ugi ciemny stó³",
Long_Fancy_Low_Table = 	 "D³ugi ekskluzywny niski stó³",
Long_Light_Table = 	 "D³ugi jasny stó³",
Long_Low_Table = 	 "D³ugi niski stó³",
Long_Shelves = 	 "D³ugie pó³ki",
Long_Table = 	 "D³ugi stó³",
Long_White_Curtain = 	 "D³uga bia³a zas³ona",
Long_Wooden_Bench = 	 "D³uga drewniana ³awka",
Low_Bench_Trailer = 	 "Niska ³awa przyczepowa",
Low_Corner_Hedge = 	 "Niski naro¿ny ¿ywop³ot",
Low_Hedge = 	 "Niski ¿ywop³ot",
Low_Motel_Counter = 	 "Niski lada z motelu",
Low_Shelves = 	 "Niskie pó³ki",
Low_Toilet = 	 "Niski sedes",
Lower_Evangelical_Banner = 	 "Niski baner ewangelicki",
Mail_Box = 	 "Skrzynka na listy",
Makeshift_Chair = 	 "Krzes³o w³asnej roboty",
Makeshift_Ham_Radio = 	 "Radiostacja w³asnej roboty",
Makeshift_Mattress = 	 "Materac w³asnej roboty",
Makeshift_Radio = 	 "Radio w³asnej roboty",
Makeshift_Walkie_Talkie = 	 "Walkie-Talkie w³asnej roboty",
Mall_Chair = 	 "Krzes³o z CH",
Mall_Decoration = 	 "Dekoracja z CH",
Mall_Map = 	 "Mapa z CH",
Mall_Tile_N = 	 "P³ytka N z CH",
Mall_Tile_W = 	 "P³ytka W z CH",
Mannequin = 	 "Manekin",
Mannequin_Stand = 	 "Podest manekina",
Map_of_USA = 	 "Mapa Stanów Zjednoczonych",
March_Ridge_Road_Sign = 	 "Znak March Ridge Road",
McFudgingtons_Sign = 	 "Znak McFudgingtons",
Medical_Mirror = 	 "Lustro szpitalne",
Medical_Stool = 	 "Sto³ek szpitalny",
Medical_Tool_Drawers = 	 "Szpitalne szafki na narzêdzia",
Medicine_Cabinet = 	 "Szafka na leki",
Mediocre_Large_Table = 	 "Taki sobie du¿y stó³",
Medium_Table = 	 "Œredni stó³",
Merry_Go_Round = 	 "Karuzela",
Metal_Locker = 	 "Metalowe szafki",
Metal_Wall_Shelves = 	 "Metalowe pó³ki œcienne",
Middle_Evangelical_Banner = 	 "Œrodkowy baner ewangelicki",
Mini_Fridge = 	 "Mini-lodówka",
Mirror_And_Drawers = 	 "Szafki z lustrem",
Mobile_Bloodbag = 	 "Przenoœny worek na krew",
Mobile_Tool_Counter = 	 "Przenoœna szafka na narzêdzia",
Modern_Corner_Counter = 	 "Nowoczesna lada naro¿na",
Modern_Counter = 	 "Nowoczesna lada",
Modern_Outdoor_Lamp = 	 "Nowoczesna lampa zewnêtrzna",
Modern_Oven = 	 "Nowoczesny piekarnik",
Modern_Red_Chair = 	 "Nowoczesne czerwone krzes³o",
Modern_Washing_Machine = 	 "Nowoczesna pralka",
Modern_White_Chair = 	 "Nowoczesne bia³e krzes³o",
Monica_Elisa_Painting = 	 "Obraz Monica Elisa",
Morgue_Table = 	 "Stó³ z kostnicy",
Mortar_Grinder = 	 "MoŸdzierz i t³uczek",
Motel_Counter = 	 "Lada z motelu",
Motel_Tiled_Floor = 	 "P³ytki z motelu",
Mounted_Deer_Thropy = 	 "Wypchana g³owa jelenia",
Muldraugh_Road_Sign = 	 "Znak Muldraugh Road",
Neon_Open_Sign = 	 "Znak Neon Open",
Oak_Bar_Counter = 	 "Dêbowa lada barowa",
Oak_Corner_Bar_Counter = 	 "Dêbowa naro¿na lada barowa",
Oak_Corner_Counter = 	 "Dêbowa lada naro¿na",
Oak_Counter = 	 "Dêbowa lada",
Oak_Round_Table = 	 "Dêbowy okr¹g³y stó³",
Oakwood_Bench = 	 "Dêbowa ³awka",
Oakwood_Floor = 	 "Panele dêbowe",
Oakwood_Shelves = 	 "Dêbowe pó³ki",
Office_Desk = 	 "Biurko biurowe",
Office_Whiteboard = 	 "Tablica biurowa",
Oldies_Jukebox = 	 "Szafa graj¹ca",
Omega_Department_Painting = 	 "Obraz Omega Department",
Ominous_Sign = 	 "Znak Ominous",
Open_Wardrobe = 	 "Otwarta szafa",
Optima_Eyes_Sign = 	 "Znak Optima Eyes",
Orange_Dumpster = 	 "Pomarañczowy kontener na œmieci",
Orange_Futon = 	 "Pomarañczowe futon",
Orange_Plant = 	 "Pomarañczowa roœlina",
Orange_Zippee_Floor = 	 "Pomarañczowa pod³oga Zippee",
Organs_Poster = 	 "Plakat Organs",
Ornamental_Bush = 	 "Krzak dekoracyjny",
Oval_Outdoor_Lamp = 	 "Owalna lampa zewnêtrzna",
PAWS_Pinball_Machine = 	 "Pinball PAWS",
PAWS_Poster = 	 "Plakat PAWS",
Palm_Travel_Sign = 	 "Znak Palm Travel",
Paper_Notices = 	 "Papiery",
Park_Bench = 	 "£awka parkowa",
Parking_Meter = 	 "Licznik parkingowy",
Patient_Chair = 	 "Fotel pacjenta",
Pay_Phones = 	 "Telefon na monety",
Pharmacy_Sign = 	 "Znak Pharmacy",
Piano_Stool = 	 "Sto³ek do pianina",
Picknic_Table = 	 "Stó³ piknikowy",
Pie_Display_Stand = 	 "Wystawa na ciasta",
Pie_Menu_Sign = 	 "Znak Pie Menu",
Pie_Store_Corner_Counter = 	 "Lada naro¿na Pie Store",
Pie_Store_Counter = 	 "Lada Pie Store",
Pie_Store_Floor = 	 "Pod³oga Pie Store",
Pile_o_Crepe_Chair = 	 "Krzes³o Pile o' Crepe",
Pile_o_Crepe_Floor = 	 "Pod³oga Pile o' Crepe",
Pink_Curtain = 	 "Ró¿owa zas³ona",
Pink_Pie_Poster = 	 "Plakat Pink Pie",
Pink_Wall_Lamp = 	 "Ró¿owa lampa œcienna",
Pizza_Dinner_Table = 	 "Stó³ Pizza Dinner",
Pizzawhirled_Corner_Counter = 	 "Lada naro¿na Pizzawhirled",
Pizzawhirled_Counter = 	 "Lada Pizzawhirled",
Pizzawhirled_Floor = 	 "Pod³oga Pizzawhirled",
Plain_Fridge = 	 "Zwyk³a lodówka",
Plain_Washing_Machine = 	 "Zwyk³a pralka",
Plastic_Chair = 	 "Plastikowe krzes³o",
Playground_Slide = 	 "Zje¿d¿alnia",
Police_Sign = 	 "Znak Police",
Pony_Roam_o_Sign = 	 "Znak Pony Roam-o",
Pool_Cue_Stand = 	 "Stojak na kije bilardowe",
Pool_Table = 	 "Stó³ bilardowy",
Poor_Quality_Table = 	 "Stó³ niskiej jakoœci",
Poor_quality_Chair = 	 "Krzes³o niskiej jakoœci",
Poorly_Crafted_Corner_Counter = 	 "S³abo wykonana lada naro¿na",
Poorly_Crafted_Counter = 	 "S³abo wykonana lada",
Popcorn_Machine = 	 "Maszyna do popcornu",
Popsicle_Fridge = 	 "Lodówka do lodów",
Premium_Tech_Walkie_Talkie = 	 "Walkie-Talkie Premium Tech.",
Premium_Technologies_Ham_Radio = 	 "Radiostacja Premium Tech.",
Premium_Technologies_Radio = 	 "Radio Premium Tech.",
Premium_Technologies_Television = 	 "Telewizor Premium Tech.",
Prisoners_Bed = 	 "£ó¿ko wiêŸnia",
Public_Mail_Box = 	 "Publiczna skrzynka na listy",
Purple_Carpet = 	 "Fioletowy dywan",
Purple_Plant = 	 "Fioletowa roœlina",
Purple_Rattan_Chair = 	 "Fioletowy rattanowy fotel",
Purple_Rattan_Couch = 	 "Fioletowa rattanowa kanapa",
Purple_Tiles = 	 "Fioletowe p³ytki",
Quality_Crafted_Corner_Counter = 	 "Dobrze wykonana lada naro¿na",
Quality_Crafted_Counter = 	 "Dobrze wykonana lada",
Quality_Table = 	 "Dobrze wykonany stó³",
Rain_Collector_Barrel = 	 "Beczka na deszczówkê",
Raised_Plantbed = 	 "Podniesiona donica",
Random_Notices = 	 "Ro¿ne og³oszenia",
Recycle_Bin = 	 "Œmietnik do segregacji",
Red_Carpet = 	 "Czerwony dywan",
Red_Comfy_Chair = 	 "Czerwony wygodny fotel",
Red_Comfy_Couch = 	 "Czerwona wygodna kanapa",
Red_Fridge = 	 "Czerwona lodówka",
Red_Lamp = 	 "Czerwona lampa",
Red_Oven = 	 "Czerwony piekarnik",
Red_Pie_Poster = 	 "Czerwony plakat z ciastem",
Red_Torn_Poster = 	 "Czerwony podarty plakat",
Red_Wooden_Chair = 	 "Czerwone drewniane krzes³o",
Rest_Area_Road_Sign = 	 "Znak Rest Area Road",
Rest_Area_South_Road_Sign = 	 "Znak Rest Area South Road",
Right_Bar_Wall_Shelves = 	 "Prawe œcienne pó³ki barowe",
Road_Block = 	 "Blokada drogowa",
Road_Cone = 	 "S³upek drogowy",
Rosewood_Road_Sign = 	 "Znak Rosewood Road",
Round_Bin = 	 "Okr¹g³y œmietnik",
Round_Gravestone = 	 "Okr¹g³y nagrobek",
Round_Outdoor_Lamp = 	 "Okr¹g³a lampa zewnêtrzna",
Round_Table = 	 "Okr¹g³y stó³",
Rounded_Glass_Display_Counter = 	 "Zaokr¹glona szklana lada wystawowa",
Ruined_Poster = 	 "Zniszczony plakat",
Sale_Sign = 	 "Znak Sale",
Salon_Chair = 	 "Fotel z salonu",
Saucy_Sign = 	 "Znak Saucy",
Seahorse_Coffee_Corner_Counter = 	 "Naro¿na lada Seahorse Coffee",
Seahorse_Coffee_Counter = 	 "Lada Seahorse Coffee",
Seahorse_Coffee_Glass_Display = 	 "Szklana wystawa Seahorse Coffee",
Seahorse_Coffee_Menu_Sign = 	 "Znak Seahorse Coffee Menu",
Seat_Yourself_Sign = 	 "Znak Seat Yourself",
Security_Terminal = 	 "Komputer ochrony",
Security_Wall_Monitors = 	 "Monitory œcienne ochrony",
Sewer_Stairs = 	 "Schody do kana³ów",
Sheba_Sign = 	 "Znak Sheba",
Shoddy_Large_Table = 	 "Tandetny du¿y stó³",
Shoddy_Table = 	 "Tandetny stó³",
Shoed_for_the_Stars_Sign = 	 "Znak Shoed for the Stars",
Shop_Dispenser = 	 "Dyspenser sklepowy",
Shop_Display_Counter = 	 "Sklepowa lada wystawowa",
Sign = 	 "Znak",
Simple_Bed = 	 "Zwyk³e ³ó¿ko",
Single_Stacked_Hay = 	 "Kostka s³omy",
Slider_Window = 	 "Okno przesuwne",
SlurpBurp_Soda_Machine = 	 "Maszyna z napojem SlurpBurp",
Small_Bordeaux_Curtain = 	 "Ma³a bordowa zas³ona",
Small_Chest = 	 "Ma³a skrzynia",
Small_Chrome_Toaster = 	 "Ma³y chromowany toster",
Small_Clothes_Rack = 	 "Ma³y wieszak na ubrania",
Small_Green_Curtain = 	 "Ma³a zielona zas³ona",
Small_Mirror = 	 "Ma³e lustro",
Small_Pearl_Curtain = 	 "Ma³a per³owa zas³ona",
Small_Soda_Machine = 	 "Ma³a maszyna z napojami",
Small_Table = 	 "Ma³y stó³",
Small_White_Curtain = 	 "Ma³a bia³a zas³ona",
Small_yellow_Plant = 	 "Ma³a ¿ó³ta roœlina",
Smith_Sign = 	 "Znak Smith",
Spiffos_Arrow_Sign = 	 "Znak strza³ka Spiffo's",
Spiffos_Big_Menu = 	 "Du¿e menu Spiffo's",
Spiffos_Corner_Counter = 	 "Lada naro¿na Spiffo's",
Spiffos_Counter = 	 "Lada Spiffo's",
Spiffos_Dinner_Chair = 	 "Krzes³o Spiffo's",
Spiffos_Floor = 	 "Pod³oga Spiffo's",
Spiffos_Garbage_Bin = 	 "Œmietnik Spiffo's",
Spiffos_Logo_Large_Sign = 	 "Logo Spiffo's – du¿e",
Spiffos_Logo_Sign = 	 "Logo Spiffo's",
Spiffos_Lounge_Seat = 	 "Siedzisko Spiffo's",
Spiffos_Sign = 	 "Znak Spiffo's",
Sports_Bench = 	 "£awka sportowa",
Square_Gravestone = 	 "Kwadratowy nagrobek",
Square_Theater_Counter = 	 "Kwadratowa lada kinowa",
Standing_Vault = 	 "Sejf",
Standpipe = 	 "Rura przeciwpo¿arowa",
Stars_n_Stripes_Flag = 	 "Flaga amerykañska",
Steel_Corner_Counter = 	 "Stalowa lada naro¿na",
Steel_Counter = 	 "Stalowa lada",
Steel_Fridge = 	 "Stalowa lodówka",
Steel_Ladder = 	 "Stalowa drabina",
Stop_Sign = 	 "Znak stop",
Streetname_Sign = 	 "Znak z nazw¹ ulicy",
Stretcher_Bed = 	 "£ó¿ko polowe",
Striped_Lamp = 	 "Lampa w paski",
Sturdy_Bench = 	 "Solidna ³awka",
Sunstar_Motel_Sign = 	 "Znak Sunstar Motel",
Surgeon_Degree_Certificate = 	 "Dyplom chirurga",
Tabletop_Soda_Machine = 	 "Sto³owa maszyna z napojami",
Taco_Sign = 	 "Znak Taco",
Tactical_Walkie_Talkie = 	 "Walkie-Talkie taktyczne",
Tall_Corner_Hedge = 	 "Wysoki ¿ywop³ot naro¿ny",
Tall_Hedge = 	 "Wysoki ¿ywop³ot",
Tall_Mirror = 	 "Wysokie lustro",
Tattoo_Parlor_Sign = 	 "Znak Tattoo Parlor",
The_Drake_Sign = 	 "Znak The Drake",
The_Forgotten_Element_Poster = 	 "Plakat The Forgotten Element",
Theater_Corner_Counter = 	 "Kinowa lada naro¿na",
Theater_Counter = 	 "Lada kinowa",
Tiled_Window = 	 "Okno witra¿owe",
Time_4_Sport_Sign = 	 "Znak Time 4 Sport",
Toddler_Rug = 	 "Dywanik niemowlaka",
Tool_Bench = 	 "£awa na narzêdzia",
Torn_Picture = 	 "Podarte zdjêcie",
Toys_R_Mine_Walkie_Talkie = 	 "Walkie-Talkie Toys-R-Mine",
Toys_R_Mine_Walkie_Talkie = 	 "Walkie-Talkie Toys-R-Mine",
Toys_R_Mine_Walkie_Talkie = 	 "Walkie-Talkie Toys-R-Mine",
Toys_R_Mine_Walkie_Talkie = 	 "Walkie-Talkie Toys-R-Mine",
Toyz_Sign = 	 "Znak Toyz",
Trailer_Counter = 	 "Przyczepowa lada",
Trailer_Fixed_Seat = 	 "Przyczepowe wbudowane siedzisko",
Train_Signal = 	 "Sygnalizator kolejowy",
Trapzoid_Shop_Shelves = 	 "Trapezoidowe pó³ki sklepowe",
Trash = 	 "Œmieci",
Twiggys_Sign = 	 "Znak Twiggy's",
Twin_Beds = 	 "Podwójne ³ózko",
US_ARMY_COMM_Ham_Radio = 	 "Radiostacja US ARMY COMM.",
US_Army_Walkie_Talkie = 	 "Walkie-Talkie US Army",
Upper_Evangelical_Banner = 	 "Górny baner ewangelicki",
Vacancy_Sign = 	 "Znak Vacancy",
ValuTech_Radio = 	 "Radio ValuTech",
ValuTech_Television = 	 "Telewizor ValuTech",
ValuTech_Walkie_Talkie = 	 "Walkie-Talkie ValuTech",
Vegetable_Basket = 	 "Skrzynka na warzywa",
Venus_Fly_Trap = 	 "Pu³apka na muchy -Venus-",
Violet_Carpet = 	 "Fio³kowy dywan",
Voilet_Flowers = 	 "Fio³kowe kwiaty",
Waiting_Chairs = 	 "Krzes³a z poczekalni",
Wall_Clock = 	 "Zegar œcienny",
Wall_Shower = 	 "Prysznic œcienny",
Wall_Vault = 	 "Sejf œcienny",
Wanted_Notices = 	 "Pilne og³oszenia",
Washing_Bin = 	 "Kosz na pranie",
Water_Dispenser = 	 "Maszyna z wod¹",
Waterbeach_Hills_Painting = 	 "Obraz Waterbeach Hills",
Weathered_Notices = 	 "Wyblak³e og³oszenia",
Weighing_Scale = 	 "Waga",
West_Point_Road_Sign = 	 "Znak West Point Road",
Western_Piano = 	 "Zachodnie pianino",
Wheat = 	 "Pszenica",
Wheelie_Bin = 	 "Œmietnik na kó³kach",
Whirled_Seat = 	 "Siedzisko Whirled",
Whirled_Wide_Menu = 	 "Szerokie menu Whirled",
White_Carpet = 	 "Bia³y dywan",
White_Checkered_Tiles = 	 "Bia³e p³ytki w kratkê",
White_Corner_Counter = 	 "Bia³y lada naro¿na",
White_Counter = 	 "Bia³a lada",
White_Curtain = 	 "Bia³a zas³ona",
White_Diagonal_Tiles = 	 "Bia³e ukoœne p³ytki",
White_Display_Counter = 	 "Bia³a lada wystawowa",
White_Fancy_Shelves = 	 "Bia³e ekskluzywne pó³ki",
White_File_Cabinet = 	 "Bia³a szafka na dokumenty",
White_Fossoil_Floor = 	 "Bia³a pod³oga Fossoil",
White_Fridge = 	 "Bia³a lodówka",
White_Hanging_Sink = 	 "Bia³a umywalka podwieszana",
White_Industrial_Fridge = 	 "Bia³a lodówka przemys³owa",
White_Lamp = 	 "Bia³a lampa",
White_Lazy_Chair = 	 "Bia³y fotel wypoczynkowy",
White_Lazy_Couch = 	 "Bia³a kanapa wypoczynkowa",
White_Low_Table = 	 "Bia³y niski stó³",
White_Mall_Tile = 	 "Bia³a P³ytka z CH",
White_Microwave = 	 "Bia³a mikrofalówka",
White_Motel_Floor = 	 "Bia³a pod³oga z motelu",
White_Plant = 	 "Bia³a roœlina",
White_Simple_Chair = 	 "Bia³e zwyk³e krzes³o",
White_Sink = 	 "Bia³a umywalka",
White_Smooth_Tiles = 	 "Bia³e g³adkie p³ytki",
White_Standing_Sink = 	 "Bia³a umywalka",
White_Tiled_Window = 	 "Bia³e okno witra¿owe",
White_Tiles = 	 "Bia³e p³ytki",
White_Wall_Shelves = 	 "Bia³e pó³ki œcienne",
White_Wardrobe = 	 "Bia³a szafa",
White_Window = 	 "Bia³e okno",
White_Wooden_Chair = 	 "Bia³e drewniane krzes³o",
Window = 	 "Okno",
Wok_n_Rolls_Sign = 	 "Znak Wok n Rolls",
Wooden_Bench = 	 "Drewniana ³awka",
Wooden_Chair = 	 "Drewniane krzes³o",
Wooden_Corner_Counter = 	 "Drewniana lada naro¿na",
Wooden_Counter = 	 "Drewniana lada",
Wooden_Framed_Mirror = 	 "Lustro w drewnianej ramie",
Wooden_Ladder = 	 "Drewniana drabina",
Wooden_Shop_Shelves = 	 "Drewniane pó³ki sklepowe",
Wooden_Toilet = 	 "Drewniany sedes",
Wooden_Window = 	 "Drewniane okno",
Yellow_Carpet = 	 "¯ó³ty dywan",
Yellow_Checkered_Tiles = 	 "¯ó³te p³ytki w kratkê",
Yellow_Diagonal_Tiles = 	 "¯ó³te ukoœne p³ytki",
Yellow_Modern_Chair = 	 "¯ó³te nowoczesne krzes³o",
Yellow_Modern_Couch = 	 "¯ó³ta nowoczesna kanapa",
Yellow_Plant = 	 "¯ó³ta roœlina",
Yellow_Tiles = 	 "¯ó³te p³ytki",
Yellow_Wall_Locker = 	 "¯ó³te szafki",
Yummmess_Sign = 	 "Znak Yummmess",
Zippee_Corner_Counter = 	 "Naro¿na lada Zippee",
Zippee_Counter = 	 "Lada Zippee",
Zippee_Low_Wall_Shelves = 	 "Niskie pó³ki œcienne Zippee",
Zippee_Market_Sign = 	 "Znak Zippee Market",
Zippee_Shelves_Rack = 	 "Pó³ki magazynowe Zippee",
Zippee_Wall_Shelves = 	 "Pó³ki œcienne Zippee",

Lamp_on_Pillar = "Latarka na s³upie",
Metal_Crate = "Metalowa skrzynia",
Stone_Pile = "Kamienny kopiec",
Wooden_Picket = "Drewniany palik",
Wooden_Stairs = "Drewniane schody",
Moveable_object = "Przedmiot do przeniesienia",
Scrapable_object = "Przedmiot do rozmontowania",
	
}